A-------------------
--------------------
--SS------------SS--
--SS------------SS--
--------------------
BBBBB----B-----BBBBB
--------------------
--------------------
---GGGGGGGGGGGGGG---
WWWRWWWRWWWWRWWWRWWW
WWWRWWWRWWWWRWWWRWWW
---GGGGGGGGGGGGGG---
--------------------
--------------------
BBBBB----------BBBBB
--------------------
--SS------------SS--
--SS------------SS--
--------------------
------E-------------